for a while - какое-то время
whatever - без разницы
merge - слияние
obsolete - устаревший
at all - вообще
fork - вилка
commit - совершать, фиксировать, поручать
severely - сильно, сурово, жестоко
utilize - использовать, утилизировать
ocassionly - иногда, порой

humble - скромный
to avoid - уклонятся, избегать
to rejoice - радоваться
an admission - вход, доступ
to suggest - предлагать
to deduct - вычесть, удерживать
to earn - зарабатывать
totaling - на общую сумму
to dispose - распологать
a violation - нарушение

a deceptive - обманчивый
a concern - беспокойство, интерес
an appeal - обращение, призыв
a bead - шарик, бусинка
a glare - яркий свет, ослепительный блеск
a wrinkle - морщина, складка
a dent - вмятина
to cast - бросать, метать
than - чем, кроме

a stance - аозиция, стойка
a contribution - вклад
a commonwealth - содружество
to inflict - налагать, причинить, навязывать
to humiliate - унижать
to thwart - срывать планы
a bargain - сделка, торг
pointless - бессмысленный
a leisure - досуг, свободное время
a whine - нытьё

to precede - предшествовать
an essential - сущность, существенный
a salvage - спасение
